action: アイコン、タイトル、バッジ、ポップアップの設定・取得、アイコンクリック時の処理を管理
alarms: 時間に基づいてタスクをスケジュール、アラーム発生時の処理を実行
bookmarks: ブックマーク（お気に入り）の作成、削除、更新、検索
browsingData: ブラウザの履歴、キャッシュ、クッキーなどの閲覧データの削除
clipboardWrite: OSクリップボードにデータを書き込む
contextMenus: 右クリックメニューのカスタマイズ、メニューアイテムクリック時の処理
cookies: クッキーの取得、削除
debugger: デバッグ用のコマンド実行、デバッガーイベントの監視
declarativeNetRequest: ネットワークリクエストをフィルタリング、動的ルールの適用
devtools: Chrome DevToolsにカスタムパネルを追加、リソース情報の取得
fontSettings: ユーザーのフォント設定の取得・変更
history: ブラウザの履歴の管理、削除、検索
i18n: 拡張機能の翻訳メッセージの取得
idle: ユーザーのアイドル状態を監視、アイドル状態の処理
notifications: 通知の作成、ボタンのクリック処理
offscreen: 非表示コンテンツの管理、オフスクリーンページの作成
omnibox: アドレスバーの検索候補を管理
permissions: 拡張機能の権限の確認、動的な権限リクエスト
power: システムのスリープを防止
printing: プリンタ関連の操作、印刷ジョブの管理
privacy: ユーザーのプライバシー設定へのアクセス
readingList: 「読みたいリスト」の管理（追加、削除、更新）
runtime: 拡張機能のランタイム管理、メッセージの送受信、オプションページの操作
scripting: ページへのスクリプトやCSSの注入、コンテンツスクリプトの管理
sidePanel: 拡張機能のサイドパネルの操作
storage: ローカルストレージ、セッションストレージ、同期ストレージの管理
tabCapture: タブのメディアストリームの取得
tabGroups: タブグループの管理
tabs: タブの作成、削除、更新、状態取得、メッセージの送信
topSites: ユーザーのトップサイト（よく訪れるサイト）の取得
userScripts: ユーザーが追加したスクリプトの管理
webNavigation: ウェブページのナビゲーションイベントの監視（読み込み完了時など）
webRequest: HTTPリクエストの監視、認証要求の処理
windows: ウィンドウの作成、管理、状態の取得